R R R R R R R R R R R R R R R R
R H H H H R H H H D B B R H H R
R B B B B R H B R H H H R B B R
R B R R R R H H R R R R R R R R
R H R D H R R R R H B B H H B R
R R R R R R H H R R R R R R R R
R B R B R B H B R H H H H H H R
R H R H R H H B R H H H H H H R
R H R H R H R R R H H H H H H R
R H R H R H B B H H H H H H H R
R B R B R B H H H H H H H H H R
R R R R R R R R R R R R R R R R
